 #######
 # @...#
 #   ####
###$    #
#   #$# #
# $ #   #
#   #####
######
