 #####
 #   ####
## #$   #
# $  $$ #
# #$#.*.#
#   @...#
#########
