     #####
 #####   #
 # .. $# #
 # #.*   #
## *.#$ ##
# $  $  #
#   ## @#
#########    
