#####
#   ######
# $ .. $ #
##$ ..$$@#
 #  .. $ #
 #########
