 ####  #####
##  #  #   #
# $ ####$  #
#  $.... $ #
##    # @ ##
 #########
