#######
#     #
# $$$##
#  #..###
##  ..$ #
 # @    #
 ########
