####
#  ###
# $$.#
#@ $.#
# $ .#
# # .#
######
