  ####
  #..#
 ## .##
 #  $ #
## $ .##
#  #$$ #
#  @   #
########
